........./....
........./....
////...../....
..../....////.
..............
....../.......
...././..../..
////../..../..
......///../..
.........../..
.../......./..