..............
...../........
...../////////
../...........
../../..//////
../../../.....
//............
......///////.
///...........
...../........
...../////////